abejóti, abejója, abejójo (abejóju, abejójau, abejósiu)	сомневаться
áiškinti, áiškina, áiškino (áiškinu, áiškinau, áiškinsiu)	объяснять, разъяснять
apsistóti, apsistója, apsistójo (apsistóju, apsistójau, apsistósiu)	остановиться (в значении проживать)
atléisti, atléidžia, atléido (atléidžiu, atléidau, atléisiu)	простить, извинить; уволить, снять
atostogáuti, atostogáuja, atostogãvo (atostogáuju, atostogavaũ, atostogáusiu)	находиться в отпуске, проводить каникулы
atródyti, atródo, atródė (atródau, atródžiau, atródysiu)	казаться; выглядеть
atsakýti, atsãko, atsãkė (atsakaũ, atsakiaũ, atsakýsiu)	ответить, отвечать
atsiliẽpti, atsiliẽpia, atsi̇̀liepė (atsiliepiù, atsi̇̀liepiau, atsiliẽpsiu)	откликнуться, откликаться; отозваться, отзываться
atsimiñti, atsi̇̀mena, atsi̇̀minė (atsi̇̀menu, atsi̇̀miniau, atsimiñsiu)	вспоминать, помнить, припоминать
atsiprašýti, atsiprãšo, atsiprãšė (atsiprašaũ, atsiprašiaũ, atsiprašýsiu)	извиниться, принести извинения, просить прощения
atsisakýti, atsisãko, atsisãkė (atsisakaũ, atsisakiaũ, atsisakýsiu)	отказаться, отказываться
augi̇nti, augi̇na, augi̇no (auginù, auginaũ, augi̇̀nsiu)	выращивать, растить
áugti, áuga, áugo (áugu, áugau, áugsiu)	расти
áuklėti, áuklėja, áuklėjo (áuklėju, áuklėjau, áuklėsiu)	воспитать, воспитывать
aũtis, aũnasi, ãvėsi (aunúosi, aviaũsi, aũsiuosi)	обуваться, разуваться
baigti, baigia, baigė (baigiù, baigiaũ, bai̇gsiu)	кончить, кончать, завершить, завершать
baigtis, baigiasi, baigėsi	кончаться, завершаться
bandýti, bañdo, bañdė (bandaũ, bandžiaũ, bandýsiu)	пробовать, испытывать, пытаться
bėgióti, bėgiója, bėgiójo (bėgióju, bėgiójau, bėgiósiu)	бегать
bė́gti, bė́ga, bė́go (bė́gu, bė́gau, bė́gsiu)	бежать
bijóti, bijo, bijójo (bijaũ, bijójau, bijósiu)	бояться
bučiúoti, bučiúoja, bučiãvo (bučiúoju, bučiavaũ, bučiúosiu)	целовать
bučiúotis, bučiúojasi, bučiãvosi (bučiúojuosi, bučiavaũsi, bučiúosiuosi)	целоваться
bū́ti, yrà / bū̃na, bùvo (esù / būnù, buvaũ, bū́siu)	быть, являться, находиться
čiuožinė́ti, čiuožinė́ja, čiuožinė́jo (čiuožinė́ju, čiuožinė́jau, čiuožinė́siu)	кататься на коньках
dainúoti, dainúoja, dainãvo (dainúoju, dainavaũ, dainúosiu)	петь, исполнять
dalyváuti, dalyváuja, dalyvãvo (dalyváuju, dalyvavaũ, dalyváusiu)	участвовать, принимать участие
darýti, dãro, dãrė (daraũ, dariaũ, darýsiu)	делать; совершать; поступать; открывать, закрывать
dažýti, dãžo, dãžė (dažaũ, dažiaũ, dažýsiu)	красить
dažýtis, dãžosi, dãžėsi (dažaũsi, dažiaũsi, dažýsiuosi)	краситься
dègti, dẽga, dẽgė (degù, degiaũ, dègsiu)	гореть; жечь, зажигать
dėkóti, dėkója, dėkójo (dėkóju, dėkójau, dėkósiu)	благодарить
dė́styti, dė́sto, dė́stė (dė́stau, dė́sčiau, dė́stysiu)	преподавать, излагать
dė́ti, dẽda, dė́jo (dedù, dė́jau, dė́siu)	класть
dėvė́ti, dėvi, dėvė́jo (dėviù, dėvė́jau, dėvė́siu)	носить (одежду)
didė́ti, didė́ja, didė́jo (didė́ju, didė́jau, didė́siu)	увеличиваться, нарастать, возрастать, повышаться
di̇rbti, di̇rba, di̇rbo (di̇̀rbu, di̇̀rbau, di̇̀rbsiu)	работать, трудиться
domė́tis, dõmisi, domė́josi (domiúosi, domė́jausi, domė́siuosi)	интересоваться
dovanóti, dovanója, dovanójo (dovanóju, dovanójau, dovanósiu)	дарить
draugáuti, draugáuja, draugãvo (draugáuju, draugavaũ, draugáusiu)	дружить
draũsti, draũdžia, draũdė (draudžiù, draudžiaũ, draũsiu)	запрещать; страховать
draũstis, draũdžiasi, draũdėsi (draudžiúosi, draudžiaũsi, draũsiuosi)	страховать, страховаться
dúoti, dúoda, dãvė (dúodu, daviaũ, dúosiu)	дать, давать
džiaũgtis, džiaũgiasi, džiaũgėsi (džiaugúosi, džiaugiaũsi, džiaũgsiuosi)	радоваться
džiáuti, džiáuna, džióvė (džiáunu, džióviau, džiáusiu)	развешивать, вешать (для просушки)
džiovi̇nti, džiovi̇na, džiovi̇no (džiovinù, džiovinaũ, džiovi̇̀nsiu)	сушить
džiū́ti, džiū́sta, džiū́vo (džiū́stu, džiū́vau, džiū́siu)	сохнуть; просыхать; чахнуть
eiti, eina, ėjo (einù, ėjaũ, ei̇siu)	идти
ė́sti, ė́da, ė́dė (ė́du, ė́džiau, ė́siu)	есть (о животных)
galė́ti, gãli, galė́jo (galiù, galė́jau, galė́siu)	мочь
galióti, galiója, galiójo (galióju, galiójau, galiósiu)	быть действительным, действовать
galvóti, galvója, galvójo (galvóju, galvójau, galvósiu)	думать
gami̇̀nti, gami̇̀na, gami̇̀no (gaminù, gaminaũ, gami̇̀nsiu)	производить, изготовлять, готовить, приготовлять
gáuti, gáuna, gãvo (gáunu, gavaũ, gáusiu)	достать, получить, получать
gérti, gẽria, gė́rė (geriù, gė́riau, gérsiu)	пить
gesi̇̀nti, gesi̇̀na, gesi̇̀no (gesinù, gesinaũ, gesi̇̀nsiu)	тушить
gýdyti, gýdo, gýdė (gýdau, gýdžiau, gýdysiu)	лечить
gimdýti, gimdo, gimdė (gimdaũ, gimdžiaũ, gimdýsiu)	рожать
gi̇mti, gi̇msta, gi̇mė (gi̇̀mstu, gimiaũ, gi̇̀msiu)	родиться, рождаться
gi̇nti, gi̇na, gýnė (ginù, gýniau, gi̇̀nsiu)	защитить, защищать
girdė́ti, girdi, girdė́jo (girdžiù, girdė́jau, girdė́siu)	слышать
gyvénti, gyvẽna, gyvẽno (gyvenù, gyvenaũ, gyvénsiu)	жить
grąži̇nti, grąži̇na, grąži̇no (grąžinù, grąžinaũ, grąži̇̀nsiu)	вернуть, возвращать
griáuti, griáuna, grióvė (griáunu, grióviau, griáusiu)	рушить, разрушать
griū́ti, griū̃va, griùvo (griūvù, griuvaũ, griū́siu)	падать; рушиться; валиться
grįž̃ti, grįž̃ta, grįž̃o (grįžtù, grįžaũ, grįš̃iu)	вернуться, возвращаться
gróti, grója, grójo (gróju, grójau, grósiu)	играть (на инструменте)
gulė́ti, gùli, gulė́jo (guliù, gulė́jau, gulė́siu)	лежать
gult̃is, gùlasi, gùlėsi (gulúosi, guliaũsi, guls̃iuosi)	лечь, ложиться
ieškóti, i̇eško, ieškójo (i̇́eškau, ieškójau, ieškósiu)	искать
įgalióti, įgaliója, įgaliójo (įgalióju, įgaliójau, įgaliósiu)	доверить, доверять
ilsė́tis, i̇lsisi, ilsė́josi (ilsiúosi, ilsė́jausi, ilsė́siuosi)	отдыхать
importúoti, importúoja, importãvo (importúoju, importavaũ, importúosiu)	импортировать, ввозить
imti, i̇ma, ė́mė (imù, ėmiaũ, im̃siu)	брать
informúoti, informúoja, informãvo (informúoju, informavaũ, informúosiu)	информировать, сообщить, сообщать
išmókti, išmóksta, išmóko (išmókstu, išmókau, išmóksiu)	выучить, научиться
įžei̇sti, įžei̇džia, įžeidė (įžeidžiù, įžeidžiau, įžei̇siu)	оскорбить
jáudintis, jáudinasi, jáudinosi (jáudinuosi, jáudinausi, jáudinsiuosi)	волноваться, переживать
jaũsti, jaũčia, jaũtė (jaučiù, jaučiaũ, jaũsiu)	чувствовать, испытывать
jaũstis, jaũčiasi, jaũtėsi (jaučiúosi, jaučiaũsi, jaũsiuosi)	чувствовать себя
jodinė́ti, jodinė́ja, jodinė́jo (jodinė́ju, jodinė́jau, jodinė́siu)	ездить верхом
jóti, jója, jójo (jóju, jójau, jósiu)	ехать верхом, скакать
judė́ti, jùda, judė́jo (judù, judė́jau, judė́siu)	шевелиться
jùngti, jùngia, jùngė (jùngiu, jùngiau, jùngsiu)	включать; соединить, соединять
juokáuti, juokáuja, juokãvo (juokáuju, juokavaũ, juokáusiu)	шутить
juõktis, juõkiasi, juõkėsi (juokiúosi, juokiaũsi, juõksiuosi)	смеяться
kabi̇nti, kabi̇na, kabi̇no (kabinù, kabinaũ, kabi̇̀nsiu)	вешать, развешивать
kainúoti, kainúoja, kainãvo (kainúoju, kainavaũ, kainúosiu)	стоить
kalbė́ti, kalba, kalbė́jo (kalbù, kalbė́jau, kalbė́siu)	говорить
kalbė́tis, kalbasi, kalbė́josi (kalbúosi, kalbė́jausi, kalbė́siuosi)	разговаривать, беседовать
kálti, kãla, kãlė (kalù, kaliaũ, kálsiu)	вбивать; высекать; ковать; чеканить
kartóti, kartója, kartójo (kartóju, kartójau, kartósiu)	повторять
kàsti, kãsa, kãsė (kasù, kasiaũ, kàsiu)	копать
ką́sti, kánda, kándo (kándu, kándau, ką́siu)	кусать, есть
kei̇sti, kei̇čia, kei̇tė (keičiù, keičiaũ, kei̇siu)	менять
kei̇stis, kei̇čiasi, kei̇tėsi (keičiúosi, keičiaũsi, kei̇siuosi)	меняться, обмениваться
keliáuti, keliáuja, keliãvo (keliáuju, keliavaũ, keliáusiu)	путешествовать, странствовать, ездить
kélti, kẽlia, kė́lė (keliù, kė́liau, kélsiu)	поднимать, переводить
kéltis, kẽliasi, kė́lėsi (keliúosi, kė́liausi, kélsiuosi)	вставать, подниматься; переезжать
kèpti, kẽpa, kẽpė (kepù, kepiaũ, kèpsiu)	печь, жарить
kirpti, kerpa, kirpo (kerpù, kirpaũ, kirpsiu)	стричь; кроить; резать
klausýti, klaũso, klaũsė (klausaũ, klausiaũ, klausýsiu)	слушать; слушаться
klausýtis, klaũsosi, klaũsėsi (klausaũsi, klausiaũsi, klausýsiuosi)	слушать
kláusti, kláusia, kláusė (kláusiu, kláusiau, kláusiu)	спрашивать
klijúoti, klijúoja, klijãvo (klijúoju, klijavaũ, klijúosiu)	клеить, склеивать, наклеивать
klóti, klója, klójo (klóju, klójau, klósiu)	стлать; накрывать
kósėti, kósti, kósėjo (kósčiu, kósėjau, kósėsiu)	кашлять
kovóti, kovója, kovójo (kovóju, kovójau, kovósiu)	бороться, сражаться
kri̇sti, krinta, kri̇to (krintù, kritaũ, kri̇̀siu)	падать
kùrti, kùria, kū́rė (kuriù, kū́riau, kùrsiu)	сочинять, создавать, творить; писать (стихи); разводить
kvėpúoti, kvėpúoja, kvėpãvo (kvėpúoju, kvėpavaũ, kvėpúosiu)	дышать
kviẽsti, kviẽčia, kviẽtė (kviečiù, kviečiaũ, kviẽsiu)	приглашать
láidoti, láidoja, láidojo (láidoju, láidojau, láidosiu)	хоронить
laikýti, lai̇ko, lai̇kė (laikaũ, laikiaũ, laikýsiu)	держать; сдавать; считать
laikýtis, lai̇kosi, lai̇kėsi (laikaũsi, laikiaũsi, laikýsiuosi)	держаться; соблюдать
laimė́ti, lai̇mi, laimė́jo (laimiù, laimė́jau, laimė́siu)	выиграть, выигрывать; занять, занимать
láistyti, láisto, láistė (láistau, láisčiau, láistysiu)	поливать
lankýti, lanko, lankė (lankaũ, lankiaũ, lankýsiu)	навещать; посещать
láukti, láukia, láukė (láukiu, láukiau, láuksiu)	ждать, ожидать
láuktis, láukiasi, láukėsi (láukiuosi, láukiausi, láuksiuosi)	быть беременной
léisti, léidžia, léido (léidžiu, léidau, léisiu)	разрешить, разрешать; расходовать, тратить; издавать, выпускать; пустить, пускать
lenkti, lenkia, lenkė (lenkiù, lenkiaũ, lenksiu)	обгонять, перегонять; сгибать,обгонять, перегонять; сгибать,
lydė́ti, lydi, lydė́jo (lydžiù, lydė́jau, lydė́siu)	провожать, сопровождать
liepti, liepia, liepė (liepiù, liepiau, liepsi)	велеть, приказать
liesti, liečia, lietė (liečiù, liečiau, liesiu)	трогать, дотрагиваться, касаться
lýginti, lýgina, lýgino (lýginu, lýginau, lýginsiu)	гладить; сравнивать
li̇kti, lieka, li̇ko (liekù, likaũ, li̇̀ksiu)	остаться, оставаться
linkė́ti, liñki, linkė́jo (linkiù, linkė́jau, linkė́siu)	желать
li̇̀pti, li̇̀pa, li̇̀po (lipù, lipaũ, li̇̀psiu)	лезть, подниматься; садиться, сесть
lýti, lyja, li̇j̀o (lyja, li̇j̀o, li̇̀s)	идет дождь
liūdė́ti, liū̃di, liūdė́jo (liūdžiù, liūdė́jau, liūdė́siu)	грустить, печалиться
lùpti, lùpa, lùpo (lupù, lupau, lùpsiu)	чистить; драть
lū́žti, lū́žta, lū́žo (lū́žtu, lū́žau, lū́šiu)	ломаться
maišýti, mai̇šo, mai̇šė (maišaũ, maišiaũ, maišýsiu)	мешать; смешивать; путать
maiti̇nti, maiti̇na, maiti̇no (maitinù, maitinaũ, maiti̇̀nsiu)	кормить
manýti, mãno, mãnė (manaũ, maniaũ, manýsiu)	думать, полагать
matýti, mãto, mãtė (mataũ, mačiaũ, matýsiu)	видеть
matúotis, matúojasi, matãvosi (matúojuosi, matavaũsi, matúosiuosi)	примерять, примеривать
máudyti, máudo, máudė (máudau, máudžiau, máudysiu)	купать
máudytis, máudosi, máudėsi (máudausi, máudžiausi, máudysiuosi)	купаться; мыться
máuti, máuna, móvė (máunu, móviau, máusiu)	одеть, одевать; снять, снимать
máutis, máunasi, móvėsi (máunuosi, móviausi, máusiuosi)	надеть, надевать; снять, снимать
mažė́ti, mažė́ja, mažė́jo (mažė́ju, mažė́jau, mažė́siu)	уменьшаться, убывать, снижаться
medžióti, medžiója, medžiójo (medžióju, medžiójau, medžiósiu)	охотиться
mė́gti, mė́gsta, mė́go (mė́gstu, mė́gau, mė́gsiu)	любить
mègzti, mẽzga, mẽzgė (mezgù, mezgiaũ, mègsiu)	вязать
melstis, meldžiasi, meldėsi (meldžiúosi, meldžiaũsi, melsiuosi)	молиться
melúoti, melúoja, melãvo (melúoju, melavaũ, melúosiu)	лгать
mèsti, mẽta, mẽtė (metù, mečiaũ, mèsiu)	бросить, кинуть
miegóti, miẽga, miegójo (miegù, miegójau, miegósiu)	спать
mylė́ti, mýli, mylė́jo (mýliu, mylė́jau, mylė́siu)	любить
mirti, mi̇ršta, mi̇rė (mi̇̀rštu, miriaũ, mirsiu)	умереть, умирать, скончаться
mokė́ti, móka, mokė́jo (móku, mokė́jau, mokė́siu)	знать, уметь; платить, уплачивать
mókyti, móko, mókė (mókau, mókiau, mókysiu)	учить, обучать
mókytis, mókosi, mókėsi (mókausi, mókiausi, mókysiuosi)	учиться, изучать, заниматься
mùšti, mùša, mùšė (mušù, mušiaũ, mùšiu)	бить
naudóti, naudója, naudójo (naudóju, naudójau, naudósiu)	употреблять, пользовать, применять
naudótis, naudójasi, naudójosi (naudójuosi, naudójausi, naudósiuosi)	пользоваться, использовать
nekęsti, nekenčia, nèkentė (nekenčiù, nèkenčiau, nekę̃siu)	ненавидеть
nèrvinti, nèrvina, nèrvino (nèrvinu, nèrvinau, nèrvinsiu)	раздражать
nèrvintis, nèrvinasi, nèrvinosi (nèrvinuosi, nèrvinausi, nèrvinsiuosi)	нервничать
nešióti, nešiója, nešiójo (nešióju, nešiójau, nešiósiu)	носить
nèšti, nẽša, nẽšė (nešù, nešiaũ, nèšiu)	нести
norė́ti, nóri, norė́jo (nóriu, norė́jau, norė́siu)	хотеть
nugalė́ti, nùgali, nugalė́jo (nùgaliu, nugalė́jau, nugalė́siu)	пересилить, пересиливать; одолеть, преодолеть; победить, побеждать
núomoti, núomoja, núomojo (núomoju, núomojau, núomosiu)	сдать, сдавать внаем
nusprę́sti, nuspréndžia, nuspréndė (nuspréndžiu, nuspréndžiau, nusprę́siu)	решить, решать
nustèbti, nustemba, nustẽbo (nustembù, nustebaũ, nustèbsiu)	удивиться, удивляться
pabùsti, pabuñda, pabùdo (pabundù, pabudaũ, pabùsiu)	проснуться, просыпаться, пробудиться, пробуждаться
padė́ti, pàdeda, padė́jo (pàdedu, padė́jau, padė́siu)	помочь, помогать, оказать помощь
pakúoti, pakúoja, pakãvo (pakúoju, pakavaũ, pakúosiu)	паковать, упаковывать, укладывать
pamiršti, pamiršta, pamiršo (pamirštù, pamiršaũ, pamiršiu)	забыть, забывать
pardúoti, pardúoda, pardavė (pardúodu, pardaviau, pardúosiu)	продать, продавать
pãsakoti, pãsakoja, pãsakojo (pãsakoju, pãsakojau, pãsakosiu)	рассказывать, повествовать
pasiklýsti, pasiklýsta, pasiklýdo (pasiklýstu, pasiklýdau, pasiklýsiu)	заблудиться
pasirašýti, pasirãšo, pasirãšė (pasirašaũ, pasirašiaũ, pasirašýsiu)	подписаться, подписываться, расписаться, расписываться, подписать, подписывать
pasiti̇kti, pasitinka, pasiti̇ko (pasitinkù, pasitikaũ, pasiti̇̀ksiu)	встретить, встречать
pastebė́ti, pàstebi, pastebė́jo (pàstebiu, pastebė́jau, pastebė́siu)	заметить, замечать, приметить, примечать, подметить, подмечать
pati̇kti, patinka, pati̇ko (patinkù, patikaũ, pati̇̀ksiu)	нравиться, понравиться
pavargti, pavargsta, pavargo (pavargstù, pavargaũ, pavargsiu)	устать, уставать
pavydė́ti, pavýdi, pavydė́jo (pavýdžiu, pavydė́jau, pavydė́siu)	завидовать
pažei̇sti, pažei̇džia, pàžeidė (pažeidžiù, pàžeidžiau, pažei̇siu)	нарушить, нарушать
paži̇nti, pažį́sta, paži̇no (pažį́stu, pažinaũ, paži̇̀nsiu)	знать, быть знакомым
piẽšti, piẽšia, piẽšė (piešiù, piešiaũ, piẽšiu)	рисовать
pietáuti, pietáuja, pietãvo (pietáuju, pietavaũ, pietáusiu)	обедать
pỹkti, pỹksta, pỹko (pykstù, pykaũ, pỹksiu)	сердиться, злиться
pỹktis, pỹkstasi, pỹkosi (pỹkstuosi, pykaũsi, pỹksiuosi)	ссориться, быть в ссоре
pi̇lti, pi̇la, pýlė (pilù, pýliau, pi̇̀lsiu)	лить, наливать
pirkti, perka, pirko (perkù, pirkaũ, pirksiu)	купить, покупать
pjáuti, pjáuna, pjóvė (pjáunu, pjóviau, pjáusiu)	резать; пилить; косить
planúoti, planúoja, planãvo (planúoju, planavaũ, planúosiu)	планировать
pláukioti, pláukioja, pláukiojo (pláukioju, pláukiojau, pláukiosiu)	плавать
plaũkti, plaũkia, plaũkė (plaukiù, plaukiaũ, plaũksiu)	плыть
pláutis, pláunasi, plóvėsi (pláunuosi, plóviausi, pláusiuosi)	мыть
plýšti, plýšta, plýšo (plýštu, plýšau, plýšiu)	рваться, разрываться
pradė́ti, pràdeda, pradė́jo (pràdedu, pradė́jau, pradė́siu)	начать, начинать
pranèšti, pràneša, prànešė (prànešu, prànešiau, pranèšiu)	сообщить, сообщать, известить, извещать
prasidė́ti, prasi̇deda, prasidė́jo (prasi̇̀deda, prasidė́jo, prasidės̃)	начаться, начинаться
prašýti, prãšo, prãšė (prašaũ, prašiaũ, prašýsiu)	просить
praũsti, praũsia, praũsė (prausiù, prausiaũ, praũsiu)	мыть, умывать
praũstis, praũsiasi, prausėsi (prausiúosi, prausiaũsi, praũsiuosi)	мыться, умываться
pripràsti, priprañta, priprãto (priprantù, priprataũ, pripràsiu)	привыкнуть, привыкать
pristatýti, pristãto, pristãtė (pristataũ, pristačiaũ, pristatýsiu)	представить, представлять
privalė́ti, privãlo, privalė́jo (privalaũ, privalė́jau, privalė́siu)	быть должным, быть обязанным
puõšti, puõšia, puõšė (puošiù, puošiaũ, puõšiu)	украшать, наряжать
puõštis, puõšiasi, puošėsi (puošiúosi, puošiaũsi, puõšiuosi)	наряжаться
pùsryčiauti, pùsryčiauja, pùsryčiavo (pùsryčiauju, pùsryčiavau, pùsryčiausiu)	завтракать
pū̃sti, pùčia, pū̃tė (pučiù, pūčiaũ, pū̃siu)	дуть, веять; раздуть, надувать
raki̇̀nti, raki̇̀na, raki̇̀no (rinkinù, rakinaũ, raki̇̀nsiu)	запирать, замыкать, отпирать, отмыкать
rami̇nti, rami̇na, rami̇no (raminù, raminaũ, rami̇̀nsiu)	успокоить, успокаивать
ràsti, rañda, rãdo (randù, radaũ, ràsiu)	найти, находить
rašýti, rãšo, rãšė (rašaũ, rašiaũ, rašýsiu)	писать
registrúoti, registrúoja, registrãvo (registrúoju, registravaũ, registrúosiu)	регистрировать
reikaláuti, reikaláuja, reikalãvo (reikaláuju, reikalavaũ, reikaláusiu)	требовать
reikė́ti, rei̇kia, reikė́jo (rei̇kia, reikė́jo, reikė̃s)	быть нужным, требоваться, надо
réikšti, réiškia, réiškė (réiškiu, réiškiau, réikšiu)	значить, означать; выражать
rėkti, rėkia, rėkė (rėkiù, rėkiaũ, rė̃ksiu)	кричать, орать
reñgti, reñgia, reñgė (rengiù, rengiaũ, reñgsiu)	готовить
reñgti, reñgia, reñgė (rengiù, rengiaũ, reñgsiu)	одевать, раздевать
reñgtis, reñgiasi, reñgėsi (rengiúosi, rengiaũsi, reñgsiuosi)	надевать, раздевать
riñkti, reñka, riñko (renkù, rinkaũ, riñksiu)	собирать; выбирать; избирать
riñktis, reñkasi, riñkosi (renkúosi, rinkaũsi, riñkčiausi)	выбирать; собираться
ri̇̀šti, ri̇̀ša, ri̇̀šo (rišù, rišaũ, ri̇̀šiu)	связывать, завязывать,
ródyti, ródo, ródė (ródau, ródžiau, ródysiu)	покaзывать
rūkýti, rū̃ko, rū̃kė (rūkaũ, rūkiaũ, rūkýsiu)	курить; коптить
rungtyniáuti, rungtyniáuja, rungtyniãvo (rungtyniáuju, rungtyniavaũ, rungtyniáusiu)	состязаться, соревноваться
ruõšti, ruõšia, ruõšė (ruošiù, ruošiaũ, ruõšiu)	готовить; собирать
ruõštis, ruõšiasi, ruõšėsi (ruošiúosi, ruošiaũsi, ruõšiuosi)	готовиться; собираться
rūpė́ti, rū̃pi, rūpė́jo (rūpiù, rūpė́jau, rūpė́siu)	заботить; интересовать
rūpintis, rūpinasi, rūpinosi (rū́pinuosi, rū́pinausi, rū́pinsiuosi)	заботиться, беспокоиться
sakýti, sãko, sãkė (sakaũ, sakiaũ, sakýsiu)	говорить
sapnúoti, sapnúoja, sapnãvo (sapnúoju, sapnavaũ, sapnúosiu)	видеть во сне, сниться
sáugoti, sáugo, sáugojo (sáugau, sáugojau, sáugosiu)	охранять, стеречь; беречь; хранить
sėdė́ti, sė́di, sėdė́jo (sė́džiu, sėdė́jau, sėdė́siu)	сидеть
sègti, sẽga, sẽgė (segù, segiaũ, sègsiu)	застегивать; прикалывать, пристегивать
sèkti, sẽka, sẽkė (sekù, sekiaũ, sèksiu)	следить; следовать
sèktis, sẽkasi, sẽkėsi (sẽkasi, sẽkėsi, sèksis)	даваться, везти
sénti, sénsta, sẽno (sénstu, senaũ, sénsiu)	стареть, стариться
sė́sti, sė́da, sė́do (sė́du, sė́dau, sė́siu)	сесть, садиться
si̇́ekti, si̇́ekia, si̇́ekė (si̇́ekiu, si̇́ekiau, si̇́eksiu)	доставать, тянуться; достигать, добиваться
sirgti, serga, sirgo (sergù, sirgaũ, sirgsiu)	болеть
siūlyti, siūlo, siūlė (siū́lau, siū́liau, siū́lysiu)	предлагать
sių̃sti, siunčia, siuntė (siunčiù, siunčiaũ, sių̃siu)	слать, посылать; отправлять
siūti, siùva, siùvo (siuvù, siuvaũ, siū́siu)	шить
skaičiúoti, skaičiúoja, skaičiãvo (skaičiúoju, skaičiavaũ, skaičiúosiu)	считать; насчитывать
skaitýti, skai̇to, skai̇tė (skaitaũ, skaičiaũ, skaitýsiu)	читать
skalbti, skalbia, skalbė (skalbiù, skalbiaũ, skalbsiu)	стирать
skambinti, skambina, skambino (skambinu, skambinau, skambinsiu)	звонить
skaudė́ti, skaũda, skaudė́jo	болеть
skélbti, skélbia, skélbė (skélbiu, skélbiau, skélbsiu)	объявлять, сообщать, оглашать
skęsti, skęsta, skendo (skęstù, skendaũ, skę̃siu)	тонуть
ski̇̀rti, ski̇̀ria, skýrė (skiriù, skýriau, ski̇̀rsiu)	делить; различать, отличать; предназначать,
ski̇rtis, ski̇riasi, skýrėsi (skiriúosi, skýriausi, ski̇̀rsiuosi)	отличаться, разводиться
skolinti, skolina, skolino (skolinu, skolinau, skolinsiu)	одалживать, давать взаймы
skri̇sti, skrenda, skri̇do (skrendù, skridaũ, skri̇̀siu)	лететь
skubė́ti, skùba, skubė́jo (skubù, skubė́jau, skubė́siu)	спешить, торопиться
skùsti, skùta, skùto (skutù, skutaũ, skùsiu)	чистить; брить
skų́sti, skùndžia, skùndė (skùndžiu, skùndžiau, skų́siu)	ябедничать; доносить
skųstis, skùndžiasi, skùndėsi (skùndžiuosi, skùndžiausi, skų́siuosi)	жаловаться
slidinė́ti, slidinė́ja, slidinė́jo (slidinė́ju, slidinė́jau, slidinė́siu)	кататься на лыжах
sni̇gti, sninga, sni̇go	идет / падает снег
sodi̇nti, sodi̇na, sodi̇no (sodinù, sodinaũ, sodi̇̀nsiu)	садить, сажать
spáusdinti, spáusdina, spáusdino (spáusdinu, spáusdinau, spáusdinsiu)	печатать
spė́ti, spė́ja, spė́jo (spė́ju, spė́jau, spė́siu)	успевать
sportúoti, sportúoja, sportãvo (sportúoju, sportavaũ, sportúosiu)	заниматься спортом
sprę́sti, spréndžia, spréndė (spréndžiu, spréndžiau, sprę́siu)	решать
stabdýti, stabdo, stabdė (stabdaũ, stabdžiaũ, stabdýsiu)	останавливать
statýti, stãto, stãtė (stataũ, stačiaũ, statýsiu)	строить; ставить
stebė́ti, stẽbi, stebė́jo (stebiù, stebė́jau, stebė́siu)	наблюдать
stebė́tis, stẽbisi, stebė́josi (stebiúosi, stebė́jausi, stebė́siuosi)	удивляться, изумляться, поражаться
stóti, stója, stójo (stóju, stójau, stósiu)	становиться; останавливаться;
stótis, stójasi, stójosi (stójuosi, stójausi, stósiuosi)	встать, вставать
stovė́ti, stóvi, stovė́jo (stóviu, stovė́jau, stovė́siu)	стоять
studijúoti, studijúoja, studijãvo (studijúoju, studijavaũ, studijúosiu)	учить, изучать, изучить
sùkti, sùka, sùko (sukù, sukaũ, sùksiu)	крутить, кружить; поворачивать; вить
sùktis, sùkasi, sùkosi (sukúosi, sukaũsi, sùksiuosi)	крутиться, кружиться; разворачиваться
supaži̇ndinti, supaži̇ndina, supaži̇ndino (supaži̇̀ndinu, supaži̇̀ndinau, supaži̇̀ndinsiu)	познакомить; ознакомить
supràsti, suprañta, suprãto (suprantù, suprataũ, supràsiu)	понять, понимать
susipaži̇nti, susipažį́sta, susipaži̇no (susispažį́stu, susipažinaũ, susipaži̇̀nsiu)	познакомиться; ознакомиться
susiti̇kti, susitinka, susiti̇ko (susitinkù, susitikaũ, susiti̇̀ksiu)	встретиться, встречаться
suti̇kti, sutinka, suti̇ko (sutinkù, sutikaũ, suti̇̀ksiu)	встретить; согласиться
svajóti, svajója, svajójo (svajóju, svajójau, svajósiu)	мечтать
svéikinti, svéikina, svéikino (svéikinu, svéikinau, svéikinsiu)	поздравлять
svéikintis, svéikinasi, svéikinosi (svéikinuosi, svéikinausi, svéikinsiuosi)	здороваться
svei̇kti, svei̇ksta, svei̇ko (sveikstù, sveikaũ, svei̇ksiu)	выздоравливать
sverti, svẽria, svėrė (sveriù, svėriaũ, sversiu)	взвешивать; весить
šálti, šą̃la, šãlo (šąlù, šalaũ, šálsiu)	мерзнуть, замерзать; морозить
šaũkti, šaũkia, šaũkė (šaukiù, šaukiaũ, šaũksiu)	кричать; звать; созывать; вызывать
šáuti, šáuna, šóvė (šáunu, šóviau, šáusiu)	стрелять
šérti, šẽria, šė́rė (šeriù, šė́riau, šérsiu)	кормить (животных)
ši̇̀ldyti, ši̇̀ldo, ši̇̀ldė (ši̇̀ldau, ši̇̀ldžiau, ši̇̀ldysiu)	греть, подогревать, обогревать
ši̇lti, šỹla, ši̇lo (šylù, šilaũ, ši̇̀lsiu)	теплеть, согреваться
šypsótis, šỹpsosi, šypsójosi (šypsaũsi, šypsójausi, šypsósiuosi)	улыбаться
šlúostyti, šlúosto, šlúostė (šlúostau, šlúosčiau, šlúostysiu)	вытирать, утирать
šlúoti, šlúoja, šlãvė (šlúoju, šlaviaũ, šlúosiu)	мести, подметать
šnekė́ti, šnẽka, šnekė́jo (šnekù, šnekė́jau, šnekė́siu)	говорить
šókti, šóka, šóko (šóku, šókau, šóksiu)	танцевать; прыгнуть
šukúoti, šukúoja, šukãvo (šukúoju, šukavaũ, šukúosiu)	причесывать
šukúotis, šukúojasi, šukãvosi (šukúojuosi, šukavaũsi, šukúosiuosi)	причесываться, расчесывать
švęsti, švenčia, šventė (švenčiù, švenčiaũ, švę̃siu)	праздновать
šviẽsti, šviẽčia, šviẽtė (šviečiù, šviečiaũ, šviẽsiu)	светить; просвещать
taisýti, tai̇so, tai̇sė (taisaũ, taisiaũ, taisýsiu)	ремонтировать, исправлять, чинить
tapýti, tãpo, tãpė (tapaũ, tapiaũ, tapýsiu)	писать (красками)
tàpti, tampa, tãpo (tampù, tapaũ, tàpsiu)	стать
tarti, tãria, tãrė (tariù, tariaũ, tarsiu)	произнести, произносить, выговаривать
taupýti, taũpo, taũpė (taupaũ, taupiaũ, taupýsiu)	копить, экономить
tei̇gti, tei̇gia, tei̇gė (teigiù, teigiaũ, tei̇gsiu)	утверждать
teiráutis, teiráujasi, teirãvosi (teiráujuosi, teiravaũsi, teiráusiuosi)	справляться, узнавать
tei̇sti, tei̇sia, tei̇sė (teisiù, teisiaũ, tei̇siu)	судить
tekė́ti, tẽka, tekė́jo (tekù, tekė́jau, tekė́siu)	течь, литься; выходить замуж;
tèpti, tẽpa, tẽpė (tepù, tepiaũ, tèpsiu)	мазать, смазывать; пачкать
tikė́ti, ti̇̀ki, tikė́jo (tikiù, tikė́jau, tikė́siu)	верить
tikė́tis, ti̇kisi, tikė́josi (tikiúosi, tikė́jausi, tikė́siuosi)	надеяться
ti̇kti, tinka, ti̇ko (tinkù, tikaũ, ti̇̀ksiu)	годиться, подходить
tylė́ti, tỹli, tylė́jo (tyliù, tylė́jau, tylė́siu)	молчать
tilpti, telpa, tilpo (telpù, tilpaũ, tilpsiu)	поместиться, помещаться
tingė́ti, ti̇ngi, tingė́jo (ti̇̀ngiu, tingė́jau, tingė́siu)	лениться
tirpti, tirpsta, tirpo (tirpstù, tirpaũ, tirpsiu)	таять, растаивать; растворяться; неметь
ti̇rti, ti̇ria, týrė (tiriù, týriau, ti̇̀rsiu)	расследовать, обследовать
triukšmáuti, triukšmáuja, triukšmãvo (triukšmáuju, triukšmavaũ, triukšmáusiu)	шуметь
trukdýti, trùkdo, trùkdė (trukdaũ, trukdžiaũ, trukdýsiu)	мешать, беспокоить
trū́kti, trū́ksta, trū́ko (trū́kstu, trū́kau, trū́ksiu)	рваться; недоставать, не хватать
tuõktis, tuõkiasi, tuõkėsi (tuokiúosi, tuokiaũsi, tuõksiuosi)	вступать в брак, бракосочетаться, венчаться
tupė́ti, tùpi, tupė́jo (tupiù, tupė́jau, tupė́siu)	сидеть (о птицах); сидеть на корточках (о человеке)
turė́ti, tùri, turė́jo (turiù, turė́jau, turė́siu)	иметь; быть должным
tvarkýti, tvarko, tvarkė (tvarkaũ, tvarkiaũ, tvarkýsiu)	убирать; управлять
ūkininkáuti, ūkininkáuja, ūkininkãvo (ūkininkáuju, ūkininkáuju, ūkininkáusiu)	хозяйствовать, заниматься хозяйством
uogáuti, uogáuja, uogãvo (uogáuju, uogavaũ, uogáusiu)	собирать ягоды
užmi̇gti, užmiñga, užmi̇go (užmingù, užmigaũ, užmi̇̀gsiu)	засыпать, уснуть
vadi̇nti, vadi̇na, vadi̇no (vadinù, vadinaũ, vadi̇̀nsiu)	называть, звать
vadováuti, vadováuja, vadovãvo (vadováuju, vadovavaũ, vadováusiu)	руководить
vaidi̇̀nti, vaidi̇̀na, vaidi̇̀no (vaidinù, vaidinaũ, vaidi̇̀nsiu)	играть (на сцене), исполнять роль, изображать
váikščioti, váikščioja, váikščiojo (váikščioju, váikščiojau, váikščiosiu)	ходить; гулять
vairúoti, vairúoja, vairãvo (vairúoju, vairavaũ, vairúosiu)	вести, водить (о транспорте), управлять
váišinti, váišina, váišino (váišinu, váišinau, váišinsiu)	угощать
vakarieniáuti, vakarieniáuja, vakarieniãvo (vakarieniáuju, vakarieniavaũ, vakarieniáusiu)	ужинать
válgyti, válgo, válgė (válgau, válgiau, válgysiu)	есть, кушать
valýti, vãlo, vãlė (valaũ, valiaũ, valýsiu)	чистить, очищать, убирать
vartóti, vartója, vartójo (vartóju, vartójau, vartósiu)	принимать (лекарства), употреблять, потреблять; использовать, пользоваться
važinė́ti, važinė́ja, važinė́jo (važinė́ju, važinė́jau, važinė́siu)	ездить, разъезжать, катать
važiúoti, važiúoja, važiãvo (važiúoju, važiavaũ, važiúosiu)	ехать
vei̇kti, vei̇kia, vei̇kė (veikiù, veikiaũ, vei̇ksiu)	делать; действовать; влиять
vėlúoti, vėlúoja, vėlãvo (vėlúoju, vėlavaũ, vėlúosiu)	опаздывать
versti, verčia, vertė (verčiù, verčiaũ, versiu)	валить; переворачивать; переводить;заставлять, принуждать; превращать; опрокидывать
vértinti, vértina, vértino (vértinu, vértinau, vértinsiu)	ценить; оценивать
vèsti, vẽda, vẽdė (vedù, vedžiaũ, vèsiu)	вести, водить; жениться;
vilkė́ti, vilki, vilkė́jo (vilkiù, vilkė́jau, vilkė́siu)	носить (об одежде), быть одетым
vilktis, velkasi, vilkosi (velkúosi, vilkaũsi, vilksiuosi)	надевать, одеваться
vi̇rti, vérda, vi̇rė (vérdu, viriaũ, vi̇̀rsiu)	кипеть; варить
võgti, vãgia, võgė (vagiù, vogiaũ, võgsiu)	красть
žadė́ti, žãda, žadė́jo (žadù, žadė́jau, žadė́siu)	обещать
žãdinti, žãdina, žãdino (žãdinu, žãdinau, žãdinsiu)	будить; пробуждать; возбуждать
žaibúoti, žaibúoja, žaibãvo	сверкать (о молнии)
žai̇sti, žai̇džia, žai̇dė (žaidžiù, žaidžiaũ, žai̇siu)	играть
žei̇sti, žei̇džia, žei̇dė (žeidžiù, žeidžiaũ, žei̇siu)	ранить
žydė́ti, žýdi, žydė́jo (žýdžiu, žydė́jau, žydė́siu)	цвести
žinóti, ži̇no, žinójo (žinaũ, žinójau, žinósiu)	знать
žiūrė́ti, žiū̃ri, žiūrė́jo (žiūriù, žiūrė́jau, žiūrė́siu)	смотреть, глядеть
žudýti, žùdo, žùdė (žudaũ, žudžiaũ, žudýsiu)	убивать, истреблять, губить
žūti, žūsta, žùvo (žū́stu, žuvaũ, žū́siu)	гибнуть, погибать
žvejóti, žvejója, žvejójo (žvejóju, žvejójau, žvejósiu)	ловить (рыбу), рыбачить